----------------------------------------
----------------------------------------
--bb--bb----bb--bb----bb--bb----bb--bb--
--bb--bb----bb--bb----bb--bb----bb--bb--
--bb--bb----bb--bbbbbbbb--bb----bb--bb--
--bb--bb----bb--bbbbbbbb--bb----bb--bb--
----------------bb----bb----------------
----------------bb----bb----------------
bbbbbbbbbbbbbb------------bbbbbbbbbbbbbb
bbbbbbbbbbbbbb------------bbbbbbbbbbbbbb
----------------bb----bb----------------
----------------bb----bb----------------
----------------------------------------
--wwwwwwwwwwww--wwwwwwww--wwwwwwwwwwww--
--wwwwwwwwwwww--wwwwwwww--wwwwwwwwwwww--
----------------------------------------
----------------------------------------
--bb------------bbbbbbbb------------bb--
--bb------------bbbbbbbb------------bb--
--bb--------------------------------bb--
--bb--------------------------------bb--
--bb--------------------------------bb--
--bb--------------------------------bb--
--bb--------------------------------bb--
--bb--------------------------------bb--
----------------------------------------
----------------------------------------
bbbbbb----bbbb---bb--bb---bbbb----bbbbbb
bbbbbb----bbbb---bb--bb---bbbb----bbbbbb
----------------------------------------
----------------------------------------
--bb---------bb--bb--bb--bb---------bb--
--bb---------bb--bb--bb--bb---------bb--
-------------bb--bb--bb--bb-------------
----bbbbbbbbbbb--bb--bb--bbbbbbbbbbb----
----------------------------------------
----------------------------------------
------------------bbbbbb----------------
------------------bb--bb----------------
------------------bb--bb----------------
20
0 0;19 0;5 0;15 0
8 19
10 19